11111111111111100000000000000000000000000000000000
11000110011101101000000000000000000000000000000000
11001100000000010000000000000000000000000000000000
10100000000000001000000000000000000000000000000000
11000000000100001000000000000000000000000000000000
10100000000000001000000000000000000000000000000000
10010000000000001000000000000000000000000000000000
10010000000000001000110000000000000000000000000000
11000000000000010000000000000000000000000000000000
11100000000000000000000000000000000000000000000000
10110000000010000000100000000000000000000000000000
11000000000000000010000000000000000000000000000000
11000000000100010000000000000000000000000000000000
11100000001100100000000000000000000000000000000000
10000000000100000000000000000000000000000000000000
11000000000000000000000000000000000000000000000000
11000000000000000000000000000000000000000000000000
11000000001100000000000000000000000000000000000000
01000000001000000000000000000000000000000000000000
10000000000000011000000000000000000000000000000000
10000000000000000000000000000000000000000000000000
11100000001000001000000000000000000000000000000000
00110000001000000000000000000000000000000000000000
00011000000000110000000000000000000000000000000000
00001111100000000000000000000000000000000000000000
00000000110000000000000000000000000000000000000000
00000000000000000000000000000000000000000000000000
00000000000000000000000000000000000000000000000000
00000000000000000000000000000000000000000000000000
00000000000000000000000000000000000000000000000000
