00000000000000000000000000000000110111110000000000
00000000000000000000000000000000000111011111101000
00000000000000000011110011110011111111110000000100
00000001110011110001111011100011110000000100000010
00001111111100001100001100101110001000011100000001
00110110000000000000000000100000000001110110000001
01110000000000000000000000000000000000000000001001
11100100000100001100001100001100001000001110000101
11000000001100001100001100001000000000001100000110
10010000001100001100001100001100001100001100000001
10000000000000000000000000000000000000000110010000
10000000000000000000000000000000000000001000010001
10000000001100001100001100001100001100001000001010
10000000001100001100001100001100001100001100000111
10000000000000000000000000000000000000000000000011
10000000000000000000000000000000000000000000000011
10000000000000000000000000000000000000000000000101
10000000001100001100001100001100001100001100000111
10000000001100001100001100001100001100001000000111
10000000001100001100001100011100001100001000000110
10000000000000000000000000001000000000000000010100
10000000000000000000000000000000000000000000000000
10000000001100001100001100011100001100011110000000
10000000001100000100001000111000001000011010000000
10000000001100001100000100001100001000001010000000
10000000001100000100001000001100000010011000000000
11000000001100001011010011110110111111111000000000
11000000000011110011110011110011110011110000000000
11000001010000000000000000000000000000000000000000
01111111111100000000000000000000000000000000000000
