111111111111111111111111111111111111111111111111111111111111111111111111111111111111111111111111
111100000000000000000000000000000000000000000000000000000000000000000000000000000000000000001111
111100000000000000000000000000000000000000000000000000000000000000000000000000000000000000001111
111100000000000000000000000000000000000000000000000000000000000000000000000000000000000000001111
111100000000000000000000000000000000000000000000000000000000000000000000000000000000000000001111
111100000000000000000000000000000000000000000000000000000000000000000000000000000000000000001111
111100000000000000001100000000000000000000000000000000000000000000000000000000000000000000001111
111100000000000000001100000000000000000000000000000000000000000000000000000000000000000000001111
111100000000000000000000000000000000000000000000000000000000000000000000000000000000000000001111
111100000000000000000000000000000000000000000000000000000000000000000000000000000000000000001111
111100000000000000000000000000000000000000000000000000000000000000000000000000000000000000001111
111100000000000000000000000000000000000000000000000000000000000000000000000000000000000000001111
111100000000000000000000000000000000000000000000000000000000000000000000000000000000000000001111
111100000000000000000000000000000000000000000000000000000000000000000000000000000000000000001111
111100000000000000000000000000000000000000000000000000000000000000000000000000000000000000001111
111100000000000000000000000000000000000000000000000000000000000000000000000000000000000000001111
111100000000000000000000000000000000000000000000000000000000000000000000000000000000000000001111
111100000000000000000000000000000000000000000000000000000000000000000000000000000000000000001111
111100000000000000000000000000000000000000000000000000000000000000000000000000000000000000001111
111100000000000000000000000000000000000111000000000000000000000000000000000000000000000000001111
111100000000000000000000000000000000000000000000000000000000000000000000000000000000000000001111
111100000000000000000000000000000000000000000000000000000000000000000000000000000000000000001111
111100000000000000000000000000000000000000000000000000000000000000000000000000000000000000001111
111100000000000000000000000000000000000000000000000000000000000000000000000000000000000000001111
111100000000000000000000000000000000000000000000000000000000000000000000000000000000000000001111
111100000000000000000000000000000000000000000000000000000000000000000000000000000000000000001111
111100000000000000000000000000000000000000000000000000000000000000000000000000000000000000001111
111100000000000000000000000000000000000000000000000000000000000000000000000000000000000000001111
111100000000000000000000000000000000000000000000000000000000000000000000000000000000000000001111
111100000000000000000000000000000000000000000000000000000000000000000000000000000000000000001111
111100000000000000000000000000000000000000000000000000000000000000000000000000000000000000001111
111100000000000000000000000000000000000000000000000000000000000000000000000000000000000000001111
111100000000000000000000000000000000000000000000000000000000000000000000000000000000000000001111
111100000000000000000000000000000000000000000000000000000000000000000000000000000000000000001111
111100000000000000000000000000000000000000000000000000000000000000000000000000000000000000001111
111100000000000000000000000000000000000000000000000000000000000000000000000000000000000000001111
111100000000000000000000000000000000000000000000000000000000000000000000000000000000000000001111
111100000000000000000000000000000000000000000000000000000000000000000000000000000000000000001111
111100000000000000000000000000000000000000000000000000000000000000000000000000000000000000001111
111100000000000000000000000000000000000000000000000000000000000000000000000000000000000000001111
111100000000000000000000000000000000000000000000000000000000000000000000000000000000000000001111
111100000000000000000000000000000000000000000000000000000000000000000000000000000000000000001111
111100000000000000000000000000000000000000000000000000000000000000000000000000000000000000001111
111100000000000000000000000000000000000000000000000000000000000000000000000000000000000000001111
111100000000000000000000000000000000000000000000000000000000000000000000000000000000000000001111
111100000000000000000000000000000000000000000000000000000000000000000000000000000000000000001111
111100000000000000000000000000000000000000000000000000000000000000000000000000000000000000001111
111100000000000000000000000000000000000000000000000000000000000000000000000000000000000000001111
111100000000000000000000000000000000000000000000000000000000000000000000000000000000000000001111
111100000000000000000000000000000000000000000000000000000000000000000000000000000000000000001111
111100000000000000000000000000000000000000000000000000000000000000000000000000000000000000001111
111100000000000000000000000000000000000000000000000000000000000000000000000000000000000000001111
111100000000000000000000000000000000000000000000000000000000000000000000000000000000000000001111
111100000000000000000000000000000000000000000000000000000000000000000000000000000000000000001111
111100000000000000000000000000000000000000000000000000000000000000000000000000000000000000001111
111100000000000000000000000000000000000000000000000000000000000000000000000000000000000000001111
111100000000000000000000000000000000000000000000000000000000000000000000000000000000000000001111
111100000000000000000000000000000000000000000000000000000000000000000000000000000000000000001111
111100000000000000000000000000000000000000000000000000000000000000000000000000000000000000001111
111100000000000000000000000000000000000000000000000000000000000000000000000000000000000000001111
111100000000000000000000000000000000000000000000000000000000000000000000000000000000000000001111
111100000000000000000000000000000000000000000000000000000000000000000000000000000000000000001111
111100000000000000000000000000000000000000000000000000000000000000000000000000000000000000001111
111100000000000000000000000000000000000000000000000000000000000000000000000000000000000000001111
111100000000000000000000000000000000000000000000000000000000000000000000000000000000000000001111
111100000000000000000000000000000000000000000000000000000000000000000000000000000000000000001111
111100000000000000000000000000000000000000000000000000000001111100000000000000000000000000001111
111100000000000000000000000000000000000000000000000000000000000000000000000000000000000000001111
111100000000000000000000000000000000000000000000000000000000000000000000000000000000000000001111
111100000000000000000000000000000000000000000000000000000000000000000000000000000000000000001111
111100000000000000000000000000000000000000000000000000000000000000000000000000000000000000001111
111100000000000000000000000000000000000000000000000000000000000000000000000000000000000000001111
111100000000000000000000000000000000000000000000000000000000000000000000000000000000000000001111
111100000000000000000000000000000000000000000000000000000000000000000000000000000000000000000111
111100000000000000000000000000000000000000000000000000000000000000000000000000000000000000001111
111100000000000000000000000000000000000000000000000000000000000000000000000000000000000000001111
111100000000000000000000000000000000000000000000000000000000000000000000000000000000000000001111
111100000000000000000000000000000000000000000000000000000000000000000000000000000000000000001111
111100000000000000000000000000000000000000000000000000000000000000000000000000000000000000001111
111100000000000000000000000000000000000000000000000000000000000000000000000000000000000000001111
111000000000000000000000000000000000000000000000000000000000000000000000000000000000000000001111
111100000000000000000000000000000000000000000000000000000000000000000000000000000000000000001111
111100000000000000000000000000000000000000000000000000000000000000000000000000000000000000001111
111100000000000000000000000000000000000000000000000000000000000000000000000000000000000000001111
111100000000000000000000000000000000000000000000000000000000000000000000000000000000000000001111
111111111111111111111111111111111111111111111111111111111111111111111111111111111111111111111111

