1111111111111111111111111
1000000000000010000000001
1011111111111010111111101
1010000000011010000000101
1010111111011110111110101
1010100001010000100010101
1010101111010111101010101
1010101000010100001010101
1011101011110101111011101
1000001010000001000000001
1111101010111111011111101
1000100010100000010000101
1010111110101111110110101
1010000000101000000010101
1011111111101011111110101
1000000000000010000000001
1111111111111111111111111

