11111111111111111111111111111111111111111111111111
10000000000000000000000000000000000000000000000001
10000000000000000000000000000000000000000000000001
10000000001100001100001100001100001100001100000001
10000000001100001100001100001100001100001100000001
10000000000000000000000000000000000000000000000001
10000000000000000000000000000000000000000000000001
10000000001100001100001100001100001100001100000001
10000000001100001100001100001100001100001100000001
10000000001100001100001100001100001100001100000001
10000000000000000000000000000000000000000000000001
10000000000000000000000000000000000000000000000001
10000000001100001100001100001100001100001100000001
10000000001100001100001100001100001100001100000001
10000000000000000000000000000000000000000000000001
10000000000000000000000000000000000000000000000001
10000000000000000000000000000000000000000000000001
10000000001100001100001100001100001100001100000001
10000000001100001100001100001100001100001100000001
10000000001100001100001100001100001100001100000001
10000000000000000000000000000000000000000000000001
10000000000000000000000000000000000000000000000001
10000000001100001100001100001100001100001100000001
10000000001100001100001100001100001100001100000001
10000000001100001100001100001100001100001100000001
10000000001100001100001100001100001100001100000001
10000000001100001100001100001100001100001100000001
10000000000000000000000000000000000000000000000001
10000000000000000000000000000000000000000000000001
11111111111111111111111111111111111111111111111111
