111111111111111111111111111111111111111111111111111111111111111111111111111111111111111111111111111111111111111111111111
100000000000000000000000000000000000000000000000000000000000000000000000000000000000000000000000000000000000000000000001
101111111111111111000000000000000000000000000000000000000000000000000000000000000000000000000000000000000000000000000001
101111111111111111000000000000000000000000000000000000000000000000000000000000000000000000000000000000000000000000000001
101111111111111111000000000000000000000000000000000000000000000000000000000000000000000000000000000000000000000000000001
101111111111111111000000000000000000000000000000000000000000000000000000000000000000000000000000000000000000000000000001
101111111111111111000000000011100011100011100011100011100011100011100011100011100011100011100000000000000000000000000001
101111111111111111000000000011100011100011100011100011100011100011100011100011100011100011100000000000000000000000000001
101111111111111111000000000011100011100011100011100011100011100011100011100011100011100011100000000000000000000000000001
101111111111111111000000000011100011100011100011100011100011100011100011100011100011100011100000000000000000000000000001
101111111111111111000000000011100011100011100011100011100011100011100011100011100011100011100000000000000000000000000001
101111111111111111000000000011100011100011100011100011100011100011100011100011100011100011100000000000000000000000000001
101111111111111111000000000000000011100000000011100000000011100000000011100000000011100000000000000000000000000000000001
101111111111111111000000000000000011100000000011100000000011100000000011100000000011100000000000000000000000000000000001
100000000000000000111100000011100011100011100011100011100011100011100011100011100011100011100000000000000000000000000001
100000000000000000111100000011100000000011100000000011100000000011100000000011100000000011100000000000000000000000000001
100000000000000000111100000011100000000011100000000011100000000011100000000011100000000011100000000000000000001100000001
100000000000000000111100000011100011100011100011100011100011100011100011100011100011100011100000000000000000001100000001
100000000011000000111100000011100011100011100011100011100011100011100011100011100011100011100000000000000000000000000001
100000000011000000111100000011100011100011100011100011100011100011100011100011100011100011100000000000000000000000000001
100000000000000000000011110011100011100011100011100011100011100011100011100011100011100011100000000000000000000000000001
100000000000000000000011110011100011100011100011100011100011100011100011100011100011100011100000000000000000000000000001
100000000000000000000011110000000011100000000011100000000011100000000011100000000011100000000000000000001100000000000001
100000000000000000000011110000000011100000000011100000000011100000000011100000000011100000000000000000001100000000000001
100000000000001100000011110011100011100011100011100011100011100011100011100011100011100011100000000000000000000000000001
100000000000001100000011110011100000000011100000000011100000000011100000000011100000000011100000000000000000000000000001
100000000000000000111100000011100000000011100000000011100000000011100000000011100000000011100000000000000000000000000001
100000000000000000111100000011100011100011100011100011100011100011100011100011100011100011100000000000000000000000000001
100000000000000000111100000011100011100011100011100011100011100011100011100011100011100011100000000000000000110000000001
100000000000000000111100000011100011100011100011100011100011100011100011100011100011100011100000000000000000110000000001
100000001100000000111100000011100011100011100011100011100011100011100011100011100011100011100000000000000000000000000001
100000001100000000111100000011100011100011100011100011100011100011100011100011100011100011100000000000000000000000000001
100000000000000000000000000000000011100000000011100000000011100000000011100000000011100000000000000000000000000000000001
100000000000000000000000000000000011100000000011100000000011100000000011100000000011100000000000000000000000000000000001
100000000000000000000000000011100011100011100011100011100011100011100011100011100011100011100011110000000000000000000001
100000000000000000000000000011100000000011100000000011100000000011100000000011100000000011100011110000000000000000000001
100000000000000000000000000011100000000011100000000011100000000011100000000011100000000011100011110000000000000000000001
100000000000000000000000000011100011100011100011100011100011100011100011100011100011100011100011110000000000000000000001
100000000000000000000000000000000000000000000000000000000000000000000000000000000000000000000011110000000000000000000001
100000000000000000000000000000000000000000000000000000000000000000000000000000000000000000000011110000000000000000000001
100000000000000000000000000000000000000000000000000000000000000000000000000000000000000000000000001111000000000000000001
100000000000000000000000000000000000000000000000000000000000000000000000000000000000000000000000001111000000000000000001
100000000000000000000000000000000011100000000011100000000011100000000011100000000011100000000000001111000000000000000001
100000000000000000000000000000000011100000000011100000000011100000000011100000000011100000000000001111000000000000000001
100000000000000000000000000011100011100011100011100011100011100011100011100011100011100011100000001111000000000000000001
100000000000000000000000000011100000000011100000000011100000000011100000000011100000000011100000001111000000000000000001
100000000000000000000000000011100000000011100000000011100000000011100000000011100000000011100000000000000000000000000001
100000000000000000000000000011100011100011100011100011100011100011100011100011100011100011100000000000000000000000000001
100000000000000000000000000011100011100011100011100011100011100011100011100011100011100011100000000000000000000000000001
100000000000000000000000000011100011100011100011100011100011100011100011100011100011100011100000000000000000000000000001
100000000000000000000000000000000000000000000000000000000000000000000000000000000000000000000000000000000000000000000001
100000000000000000000000000000000000000000000000000000000000000000000000000000000000000000000000000000000000000000000001
100000000000000000000000000000000000000000000000000000000000000000000000000000000000000000000000000000000000000000000001
100000000000000000000000000000000000000000000000000000000000000000000000000000000000000000000000000000000000000000000001
100000000000000000000000000011100011100011100011100011100011100011100011100011100011100011100000000000000000000000000001
100000000000000000000000000011100011100011100011100011100011100011100011100011100011100011100000000000000000000000000001
100000000000000000000000000011100011100011100011100011100011100011100011100011100011100011100000000000000000000000000001
100000000000000000000000000011100011100011100011100011100011100011100011100011100011100011100000000000000000000000000001
100000000000000000000000000000000000000000000000000000000000000000000000000000000000000000000000000000000000000000000001
100000000000000000000000000000000000000000000000000000000000000000000000000000000000000000000000000000000000000000000001
100000000000000000000000000000000000000000000000000000000000000000000000000000000000000000000000000000000000000000000001
100000000000000000000000000000000000000000000000000000000000000000000000000000000000000000000000000000000000000000000001
100000000000000000000000000000000000000000000000000000000000000000000000000000000000000000000000000000000000000000000001
100000000000000000000000000000000000000000000000000000000000000000000000000000000000000000000000000000000000000000000001
100000000000000000000000000000000000000000000000000000000000000000000000000000000000000000000000001111111111111111111101
100000000000000000000000000000000000000000000000000000000000000000000000000000000000000000000000001111111111111111111101
100000000000000000000000000000000000000000000000000000000000000000000000000000000000000000000000001111111111111111111101
100000000000000000000000000000000000000000000000000000000000000000000000000000000000000000000000001111111111111111111101
100000000000000000000000000000000000000000000000000000000000000000000000000000000000000000000000001111111111111111111101
100000000000000000000000000000000000000000000000000000000000000000000000000000000000000000000000001111111111111111111101
100000000000000000000000000000000000000000000000000000000000000000000000000000000000000000000000001111111111111111111101
100000000000000000000000000000000000000000000000000000000000000000000000000000000000000000000000001111111111111111111101
100000000000000000000000000000000000000000000000000000000000000000000000000000000000000000000000001111111111111111111101
100000000000000000000000000000000000000000000000000000000000000000000000000000000000000000000000001111111111111111111101
100000000000000000000000000000000000000000000000000000000000000000000000000000000000000000000000001111111111111111111101
100000000000000000000000000000000000000000000000000000000000000000000000000000000000000000000000001111111111111111111101
100000000000000000000000000000000000000000000000000000000000000000000000000000000000000000000000001111111111111111111101
100000000000000000000000000000000000000000000000000000000000000000000000000000000000000000000000001111111111111111111101
100000000000000000000000000000000000000000000000000000000000000000000000000000000000000000000000000000000000000000000001
111111111111111111111111111111111111111111111111111111111111111111111111111111111111111111111111111111111111111111111111
